...............
...............
1..............
######.........
......GGG......
......###......
...............
..GGG.....GGG..
..###.....###..
...............
.............X.
###############
