................
................
................
................
................
................
................
................
................
................
................
................
................
..1...........X.
################
