..............X.
................
................
................
................
................
................
................
................
................
..1.............
################
