..............X.
................
................
................
................
................
................
................
................
................
1...............
################
