................
.1......---..---
.#.####.........
................
................
...........A....
.....a..$$##....
...#####......##
...............#
................
..$...........X.
.###############
