....................
.X..................
....................
....................
....................
..............A.....
.............--.....
....................
.........###........
....................
..............###...
....................
....................
..1...~~............
########...#########
