....................
.............--.....
.#.####.............
....................
....................
....................
........####........
##.#####......###...
....................
....................
....................
....................
....................
..1...............X.
########...#########
