....................
1...................
######..............
....................
.............--.....
....................
.........###........
.#####........###...
....................
....................
....................
....................
....................
..................X.
########...#########
