....................
...................X
.#####..............
....................
.............--.....
....................
.........###........
.#####........###...
....................
....................
....................
....................
....................
..1.................
########...#########
