....................
.1...........--.....
.#.####.............
....................
....................
....................
........####........
########......###...
....................
....................
....................
....................
....................
..................X.
########...#########
