....................
1...........--......
######..............
....................
....................
....................
........####........
.#######......###...
....................
....................
....................
....................
....................
..................X.
########...#########
