....................
.X..................
....................
....................
....................
..............A.....
.............--.....
....................
.........###........
....................
....................
....###.......###...
....................
.1..................
########...#########
