....................
.............--.....
######..............
....................
....................
....................
......1.####........
.#######......###...
....................
....................
....................
....................
....................
..................X.
########...#########
