....................
..A................X
.#####..............
....................
....................
....................
.............--.....
....................
.........###........
....................
..............###...
....................
....................
..1...~~............
########...#########
