................
......G....-----
.#.####.........
........####....
...#####......##
................
................
................
...............#
................
...#...1......X.
.#######...#####
