................
....@@@@d@@@@...
....@@@@@@@@@.X.
....@@@...@@@##.
....@@@@@@@@@...
....@@@@@@@@@...
....@@...D@@@...
..a.@@@@@@@@@...
..##@@@@@@@@@###
.1##@@..B.@@@###
.###@@@@@@@@@###
..##@@@@@@@@@##.
