................
................
................
.........1......
........##......
......####......
....X.#@##......
...####@##......
...#@@@@##......
...#@@@@##......
.###@@@@########
.###############
