....................
............---.....
.#.####.............
....................
....................
....................
........####........
##.#####......###...
....................
.................X..
...#................
...#................
....................
1...................
####################
