....................
............---.....
##.####.............
....................
....................
....................
........####........
##.#####......###...
....................
....................
...#................
...#................
....................
..........1.....X...
####################
