....................
.1..................
####################
....................
....................
....................
....................
....................
....................
....................
....................
....................
....................
...........X........
####################
