....................
.1.................X
####################
....................
....................
....................
....................
....................
....................
....................
....................
....................
....................
....................
####################
