...P........P...
....d.G....@@---
.#.####.........
................
................
...........A....
.....a..$###....
...#####......##
...............#
................
...#...1......X.
.#######...#####
