................
......G....-----
.#.####.........
................
................
...........A....
........####....
...#####......##
...............#
................
...#...1......X.
.#######...#####
