....................
1......####.........
##.#####......###...
....................
....................
....................
....................
...#.......--####...
...#....----........
......----..........
............X.......
####################
####################
####################
####################
