....................
.1.........---......
##.####.............
....................
....................
....................
........####........
##.#####......###...
....................
....................
...#................
...#................
....................
................X...
####################
