....................
...........---......
##.####.............
....................
....................
....................
........####........
##.#####......###...
....................
....................
...#................
...#................
....................
............1...X...
####################
