................
.1..............
################
................
................
................
................
................
................
................
...........X....
################
