................
1............X..
################
................
................
................
................
................
................
................
................
################
