.................................................
.####..#.......#...#####.#####..###..####..#...#.
.#...#.#......#.#....#...#.....#...#.#...#.##.##.
.#...#.#.....#...#...#...#.....#...#.#...#.#.#.#.
.####..#.....#...#...#...####..#...#.####..#.#.#.
.#.....#.....#####...#...#.....#...#.#.#...#...#.
.#.....#.....#...#...#...#.....#...#.#..#..#...#.
.#.....#####.#...#...#...#......###..#...#.#...#.
.................................................
.#####.#...#.####..#......###..####..#####.####..
.#.....#...#.#...#.#.....#...#.#...#.#.....#...#.
.#......#.#..#...#.#.....#...#.#...#.#.....#...#.
.####....#...####..#.....#...#.####..####..####..
.#......#.#..#.....#.....#...#.#.#...#.....#.#...
.#.....#...#.#.....#.....#...#.#..#..#.....#..#..
.#####.#...#.#.....#####..###..#...#.#####.#...#.
.................................................
.................................................
.................................................
.................................................
.................................................
.1................X..............................
.................................................
