.................................................
.####..#.......#...#####.#####..###..####..#...#.
.#...#.#......#.#....#...#.....#...#.#...#.##.##.
.#...#.#.....#...#...#...#.....#...#.#...#.#.#.#.
.####..#.....#...#...#...####..#...#.####..#.#.#.
.#.....#.....#####...#...#.....#...#.#.#...#...#.
.#.....#.....#...#...#...#.....#...#.#..#..#...#.
.#.....#####.#...#...#...#......###..#...#.#...#.
.................................................
..####.#...#..####.####...###..#...#.#####.####..
.#.....##.##.#.....#...#.#...#.#...#.#.....#...#.
.#.....#.#.#.#.....#...#.#...#.#...#.#.....#...#.
..###..#.#.#..###..####..#...#.#...#.####..####..
.....#.#...#.....#.#.....#...#.#.#.#.#.....#.#...
.....#.#...#.....#.#.....#...#.#.#.#.#.....#..#..
.####..#...#.####..#......###...#.#..#####.#...#.
.................................................
.................................................
.................................................
.................................................
.................................................
.1................X..............................
.................................................
