.................................................
.####..#.......#...#####.#####..###..####..#...#.
.#...#.#......#.#....#...#.....#...#.#...#.##.##.
.#...#.#.....#...#...#...#.....#...#.#...#.#.#.#.
.####..#.....#...#...#...####..#...#.####..#.#.#.
.#.....#.....#####...#...#.....#...#.#.#...#...#.
.#.....#.....#...#...#...#.....#...#.#..#..#...#.
.#.....#####.#...#...#...#......###..#...#.#...#.
.................................................
.............####..#...#.#...#.#...#.............
.............#...#.#...#.#...#.#..#..............
.............#...#.#...#.##..#.#.#...............
.............####..#...#.#.#.#.##................
.............#.....#...#.#..##.#.#...............
.............#.....#...#.#...#.#..#..............
.............#......###..#...#.#...#.............
.................................................
.................................................
.................................................
.................................................
.................................................
.1................X..............................
.................................................
