.............P..
......G......---
.#.####.........
................
................
...........A....
.....a..$###...1
...#####......##
...............#
...#............
...#..........X.
.###############
