................
.1...........---
.#.####.........
................
................
................
........####....
.#.#####......##
...............#
...#............
...#..........X.
.###############
