................
.1...........---
##.####.........
................
................
................
........####....
##.#####......##
...............#
...#............
...#..........X.
################
